NO ./lol.lol
SO ./lol.lol
WE ./lol.lol
EA ./lol.lol
F 220,100,0
C 225,30,5




        1111111111111111111111111
        1000000000110000000000001
        1011000001110000000000001
        1001000000000010000000001  
1111111110110000011100010N0000001
100000000011000001110111111111111
11110111111111011100000010001
11110111111111011101010010001
11000000110101011100000010001
10000000000000001100000010001
10000000000000001101010010001
11000001110101011111011110011
11110111 1110101 101111010001
11111111 1111111 111111111111