NO ./lol.lol
SO ./lol.lol
WE ./lol.lol
EA ./lol.lol
F 220,100,0
C 225,30,5

            1111111111111111111111111
            1000000000110000000000001
            10110000011100000000000111
            10010000000000000001111
111111111011000001110000000001100111
100000000011000001110111111111111
11110111111111011100000010001
10011011111111101110101001000011
1110000001101010111000000101111
10000000000000001100000010001
10000000000000001101010010001
1100000111010101111101111N0111
11110101 1110101 101111010001
11111111 1111111 111111111111