NO ./lol.lol
SO ./lol.lol
WE ./lol.lol
EA ./lol.lol
F 220,100,0
C 225,30,5

            1111111111111111111111111
            1000000000110000000000001
            1011000001110000000000011
            100100000000000000001111
11111111101100000111000000000101
100000000011000001110111111101
11110111111111011100000010001
11110111111111011101010010001
11000000110101011100000010001
10000000000000001100000010001
10000000000000001101010010001
1100000111010101111101111N0111
11110111 1110101 101111010001
11111111 1111111 111111111111