NO    ./textures/64x64/vertopal.com_brick_brown-vines3_64x64.xpm
SO ./textures/64x64/vertopal.com_brick_dark_4_4_64x64.xpm
WE ./textures/64x64/vertopal.com_brick_dark_4_11_64x64.xpm
EA ./textures/64x64/vertopal.com_wall_vines5_64x64.xpm
C 255,178,0
F 91,106,99


        1111111111111111111111111
        1000000000110000000000001
        1011000001110000000000001
        1001000000000010000000001  
111111111011000001110001N00000001
100000000011000001110111111111111
11110111111111011100000010001
11110111111111011101010010001
11000000110101011100000010001
10000000000000001100000010001
10000000000000001101010010001
11000001110101011111011110011
11110111 1110101 101111010001
11111111 1111111 111111111111