NO ./textures/MiConv.com__lab-metal2.xpm
SO ./textures/MiConv.com__lab-metal3.xpm
WE ./textures/MiConv.com__lab-metal4.xpm
EA ./textures/MiConv.com__lab-metal1.xpm
F 91,106,99
C 173,0,0






        1111111111111111111111111
        1000000000110000000000001
        1011000001110000000000001                                                                                             
        1001000000000010000000001                                                                                               
111111111011000001110001N00000001                                                                                                        
100000000011000001110111111111111                                                                                                        
11110111111111011101010010001
11000000110101011100000010001
10000000000000001100000010001
10000000000000001101010010001
11000001110101011111011110011
11110111 1110101 101111010001
11111111 1111111 111111111111