NO ./lol.lol
SO ./lol.lol
WE ./lol.lol
EA ./lol.lol
F 220,100,0
C 225,30,5




        1111111111111111111111111
        10000000001100000000001001
        10110000011100000000001001
        10010000000000000000001001
1111111110110000011100000000001001
100000000011000001110111111111111
11110111111111011100000010001
11110111111111011101010010001
11000000110101011100000010001
10000000000000001100000010001
10000000000000001101010010001
11000001110101011111011110N0111
11110111 1110101 101111010001
11111111 1111111 111111111111
